2,1,1,8,1,7,3,3,3,1,1,3,2,1,1,3,3,2,2,2,2,1,3,1,7,2,3,3,1,1,2,3,3,2,2,1,1,2,2,3,1,2,1,2,1,2,3,2,1,3,1,1,2,3,1,3,3,2,3,1,2,1,3,1,3,1,2,2,2,7,1,3,1,2,3,1,1,1,1,1,1,2,3,2,3,2,1,2,1,2,2,3,3,3,1,3,2,2,1,2,1,2,2,2,3,2,1,3,1,2,3,1,2,1,2,7,2,3,1,1,1,3,1,2,2,2,1,1,2,2,1,2,2,2,2,3,1,2,1,1,3,2,1,3,1,1,3,3,3,3,2,3,1,2,3,3,1,1,1,2,1,2,3,1,2,2,1,1,2,1,1,3,3,2,1,1,3,1,2,2,2,1,3,1,2,1,1,2,3,3,3,2,3,1,2,2,2,2,1,3,2,3,1,3,1,1,1,1,1,1,2,1,2,3,2,2,2,2,3,2,7,2,1,1,1,1,7,3,1,2,1,1,1,1,3,1,2,3,2,2,3,1,3,1,3,1,2,9,1,3,3,2,3,2,3,2,3,2,3,1,2,3,2,1,6,2,1,3,2,3,1,1,1,3,3,3,2,1,3,9,3,3,1,3,2,2,3,3,2,1,3,1,3,3,1,1,3,3,3,1,8,1,1,1,2,3,2,2,1,3,3,3,1,1,6,3,9,1,3,2,6,2,3,3,1,3,1,2,3,1,1,3,2,1,3,1,1,1,1,1,1,1,1,2,3,1,1,3,2,2,1,2,3,2,2,2,1,1,3,1,3,2,2,2,3,2,3,2,5,1,2,3,1,2,1,2,3,1,2,3,2,2,3,1,3,1,2,2,
2,2,3,2,1,1,2,3,3,2,3,2,1,3,3,2,2,1,1,3,2,3,3,2,1,1,1,3,3,2,2,3,1,1,3,3,3,2,3,3,2,1,2,2,2,2,1,6,3,3,1,1,3,3,3,1,3,3,1,3,3,8,1,1,3,1,2,2,3,3,2,1,1,3,3,1,1,1,1,3,3,2,1,8,2,2,2,3,2,1,3,2,1,2,1,2,3,2,1,1,1,2,1,2,2,1,3,3,2,3,3,2,1,1,2,2,3,3,2,2,2,2,3,2,2,3,6,2,2,3,3,2,1,3,3,2,1,2,9,2,1,3,2,3,3,2,3,3,2,3,3,1,1,3,1,3,3,2,1,2,3,2,3,3,1,3,2,1,2,1,3,3,1,1,1,1,2,2,3,1,3,2,3,9,1,2,2,1,1,1,3,3,9,1,2,2,2,2,1,3,2,2,1,1,3,8,1,2,3,2,3,1,3,3,2,1,1,2,3,2,1,2,3,3,2,6,3,1,8,1,2,1,3,1,3,1,1,3,1,8,3,1,3,3,2,2,3,2,2,3,1,6,2,3,3,2,2,3,1,3,1,2,2,2,1,2,1,2,8,2,3,2,2,1,1,2,3,1,3,2,1,1,1,1,3,2,1,1,1,3,3,1,3,2,2,3,2,2,2,1,3,2,2,2,1,3,3,3,2,3,3,3,1,3,1,2,2,2,3,3,2,3,3,1,1,2,3,1,1,1,1,3,1,3,3,2,3,1,2,3,2,3,2,1,1,1,1,2,3,2,5,2,3,1,1,3,2,3,1,3,3,3,1,1,4,2,1,3,3,3,2,2,1,3,3,3,1,3,2,1,2,2,1,3,2,3,3,3,
2,3,2,3,2,3,1,1,1,1,3,2,2,1,1,1,1,2,2,2,3,3,2,3,3,2,1,1,2,3,2,1,1,3,3,1,9,1,2,2,1,1,1,1,2,1,1,3,1,2,1,1,2,1,1,1,1,2,6,3,1,2,2,1,3,1,1,1,3,3,1,1,2,1,2,1,1,1,1,1,7,1,3,1,2,3,2,2,2,2,3,3,2,1,3,3,2,2,3,2,3,1,1,1,3,2,6,2,1,1,2,2,3,1,3,2,3,3,2,2,1,2,1,8,1,2,1,2,2,1,1,2,2,1,1,2,3,2,3,1,2,2,2,2,3,3,1,2,1,2,1,1,1,1,3,2,7,1,1,1,1,1,3,1,3,3,2,1,2,2,2,2,1,2,1,2,3,2,1,1,1,1,1,3,3,3,3,1,1,2,1,2,1,2,2,3,2,2,2,3,2,1,2,1,2,3,6,3,1,2,3,1,1,3,1,3,1,2,2,1,2,2,1,3,2,7,3,1,2,3,1,2,1,2,3,2,3,2,1,3,3,2,3,1,3,2,1,3,1,2,1,1,1,2,1,3,2,1,1,3,3,1,3,1,3,2,3,3,1,2,2,3,1,1,1,3,2,2,1,3,1,2,1,3,2,3,9,1,1,2,1,2,2,3,2,2,1,3,1,1,1,7,1,2,1,1,1,2,2,2,2,5,1,4,2,3,6,1,3,3,2,1,3,2,2,2,3,1,1,3,1,1,3,3,2,2,2,3,3,2,3,3,1,2,1,1,2,1,3,3,1,3,1,1,1,2,2,3,3,2,3,3,3,2,2,3,3,1,2,1,3,5,1,2,3,2,4,3,1,1,3,5,3,3,2,1,2,3,
2,3,2,1,3,7,3,3,3,1,3,1,3,1,1,3,1,1,2,1,2,3,1,2,3,1,2,2,3,3,3,1,2,2,2,2,2,9,2,3,2,3,2,3,9,3,1,3,3,3,1,3,3,2,2,1,1,3,9,2,3,1,2,2,2,1,1,2,2,1,2,1,3,3,3,1,3,2,3,1,3,1,2,8,3,1,3,2,1,3,1,3,2,3,3,1,3,1,3,1,3,1,3,2,2,3,2,3,1,2,2,1,1,1,1,3,1,1,1,3,1,1,3,3,2,2,3,3,2,3,2,3,3,1,2,3,2,1,2,3,2,1,2,2,1,8,1,1,3,1,3,3,3,2,1,2,1,2,2,3,1,2,1,3,1,3,3,3,3,1,9,2,3,1,3,2,2,1,3,3,3,3,1,3,1,3,2,2,2,2,2,3,3,1,2,2,1,3,1,3,2,2,2,1,1,2,2,2,3,2,1,1,1,2,3,1,1,2,3,3,1,2,2,3,1,3,2,3,2,3,1,1,2,3,3,3,2,1,3,1,3,2,3,1,1,1,2,2,3,3,2,1,1,1,2,2,3,3,2,1,1,3,2,3,3,3,3,2,1,3,1,1,1,2,1,3,2,2,2,3,2,3,2,3,1,1,1,6,3,1,2,2,1,2,3,1,2,1,3,1,2,1,3,3,2,3,2,3,1,2,2,2,1,9,2,2,3,1,1,2,1,2,3,1,1,1,1,2,2,1,1,3,2,3,3,2,3,3,1,3,4,3,1,1,2,2,1,2,1,3,7,2,2,1,3,3,2,1,3,3,3,2,1,2,1,2,2,2,2,6,5,2,1,3,3,3,6,5,2,1,3,2,1,1,2,1,1,2,
3,1,3,3,3,2,1,2,3,3,1,2,3,1,3,1,1,3,1,3,1,2,2,1,3,2,7,2,2,1,2,2,1,3,1,2,3,3,2,3,1,1,3,2,1,3,3,3,2,3,2,2,2,3,2,3,3,1,2,2,3,2,1,1,2,1,2,1,1,3,1,2,3,2,3,2,3,1,1,3,2,1,3,1,1,3,1,2,2,1,1,1,3,3,1,3,3,2,1,1,1,3,3,1,1,3,3,2,1,3,3,3,1,2,3,3,3,3,1,1,1,2,1,2,2,1,3,1,1,1,3,3,3,9,2,3,3,1,1,3,1,1,3,2,2,3,3,2,2,1,2,3,3,1,3,2,2,2,2,1,1,1,2,1,1,2,3,2,1,1,3,2,2,2,2,2,1,1,1,2,3,2,1,3,1,3,2,2,2,3,3,2,1,3,3,2,1,3,3,2,1,2,2,3,3,3,3,1,1,3,3,3,1,1,3,3,3,3,1,3,2,3,2,2,3,3,2,2,3,1,2,2,2,2,3,3,3,3,1,3,1,1,2,2,1,2,3,1,2,1,2,1,2,1,2,3,3,2,3,1,2,3,2,2,1,3,2,2,1,1,2,2,2,1,1,3,1,2,3,3,3,1,3,2,2,3,2,1,1,3,1,1,1,2,1,1,2,6,8,2,2,2,3,3,8,3,2,3,2,3,8,2,1,1,2,1,2,1,2,3,2,1,2,2,2,3,1,1,2,3,2,2,1,3,1,1,5,2,2,2,2,1,1,3,3,3,2,1,2,2,6,3,1,3,1,3,2,1,2,3,2,1,2,1,2,3,3,3,1,1,3,1,4,1,2,3,1,2,3,2,1,1,1,2,3,3,1,2,
3,3,2,1,1,1,9,3,1,2,3,3,2,2,3,2,3,2,2,1,3,2,2,2,2,3,2,3,2,2,1,1,3,3,2,1,1,1,3,3,2,2,3,3,3,3,3,1,1,2,1,3,1,2,1,1,2,3,3,2,2,3,3,1,1,3,2,3,2,3,2,3,2,1,3,3,1,2,3,3,3,1,2,1,3,3,1,1,2,2,3,1,1,1,2,2,2,3,3,3,3,2,2,1,3,3,2,3,3,2,3,1,2,2,2,2,1,1,2,3,3,3,1,2,3,2,1,3,3,2,3,1,3,2,3,1,2,2,2,3,2,2,3,3,3,2,3,1,1,2,3,1,2,3,2,2,3,1,1,2,1,1,2,3,2,2,1,2,2,2,2,1,3,3,3,2,1,2,3,1,1,2,3,1,1,1,2,3,1,3,1,3,1,2,3,3,3,2,1,3,1,1,3,3,8,3,3,3,2,2,1,1,1,3,1,1,7,2,1,2,2,2,1,2,2,3,1,1,3,2,2,3,8,3,2,2,2,3,1,3,2,2,3,1,3,1,2,1,2,2,1,1,2,1,1,1,3,3,3,2,1,1,3,2,1,1,2,3,3,1,1,2,2,2,1,2,3,2,1,2,2,2,1,2,3,3,6,2,3,2,3,1,1,2,3,1,1,3,3,1,2,1,1,1,2,1,1,3,1,2,3,3,3,3,2,1,3,3,3,3,2,3,2,1,2,1,1,1,1,2,3,2,3,3,2,2,1,2,2,2,3,1,3,2,1,1,3,4,3,1,2,2,2,1,3,3,1,1,6,3,2,1,3,2,3,3,6,2,3,2,3,3,3,1,2,1,1,2,2,1,2,1,2,1,2,3,3,1,
2,3,2,2,1,2,2,2,3,1,2,7,2,2,3,1,3,1,3,2,3,1,2,1,3,1,2,1,2,1,1,2,3,1,2,1,1,2,3,2,2,3,3,1,3,2,1,1,1,3,1,1,1,2,3,2,1,1,2,3,1,3,1,3,2,1,2,2,2,7,2,3,2,1,8,1,1,1,1,2,3,3,2,2,3,1,3,3,1,2,2,2,1,1,2,1,1,1,2,1,1,1,3,3,2,1,2,3,1,1,3,1,3,2,3,2,2,3,2,3,1,1,1,3,1,2,3,2,1,2,3,2,3,2,2,2,3,1,3,3,2,3,3,2,2,3,1,3,2,2,1,3,1,3,3,1,1,3,3,2,3,1,1,1,1,2,3,1,3,1,1,2,3,3,3,3,1,3,3,1,3,2,2,1,2,1,2,1,1,1,3,3,2,2,1,3,2,3,2,1,1,3,3,1,3,3,3,3,3,1,1,8,2,2,2,8,2,2,2,2,1,3,1,2,3,2,3,1,3,2,3,3,3,2,3,1,2,2,1,7,3,3,2,3,3,2,2,1,1,1,7,3,3,2,3,2,7,2,2,3,1,3,1,2,1,3,1,1,1,2,2,1,1,3,2,1,1,3,1,2,2,1,2,2,2,2,2,2,3,1,1,1,3,3,3,1,1,1,2,2,3,2,1,1,3,2,2,2,1,7,2,3,1,1,2,3,1,2,1,3,1,2,3,2,1,3,2,2,1,1,1,1,3,1,1,2,3,2,1,1,2,1,1,3,1,3,2,3,3,3,2,2,1,2,3,3,1,1,1,1,1,1,3,3,1,3,2,1,2,3,3,1,1,1,2,2,1,1,3,1,3,3,7,1,3,2,2,5,
1,1,3,2,1,2,3,3,2,2,2,3,3,3,1,1,2,2,2,2,1,2,3,1,3,2,1,2,1,3,3,3,9,2,1,1,3,2,1,2,1,1,1,2,2,3,2,2,2,2,3,3,1,2,3,2,3,3,3,1,1,1,1,1,2,3,2,2,1,2,2,3,2,2,3,3,2,1,3,1,3,1,3,2,3,3,3,1,1,1,3,2,3,1,1,3,1,1,1,1,2,2,1,2,2,2,3,3,2,7,3,1,2,2,2,3,2,3,2,1,3,1,2,1,2,2,3,1,2,2,1,3,2,1,2,1,1,2,3,3,1,2,1,2,1,7,2,1,2,2,3,3,3,1,3,2,3,3,3,1,1,2,1,2,1,2,1,2,2,2,2,2,1,2,2,2,1,2,2,1,1,1,2,2,2,2,3,1,2,3,9,1,1,1,3,1,2,1,2,3,2,3,1,3,3,3,1,2,3,3,3,1,3,1,3,3,3,1,2,2,2,1,3,3,1,2,3,1,3,3,3,1,1,2,3,2,2,1,3,3,1,1,3,1,2,1,1,1,2,3,1,3,2,2,2,1,1,3,1,2,1,3,1,3,2,1,1,2,1,6,3,1,3,3,1,2,1,2,2,3,3,1,3,1,3,1,1,3,1,3,2,1,1,3,2,2,2,1,3,3,2,1,3,1,1,1,2,1,1,3,3,1,2,2,2,2,1,2,3,1,3,3,1,3,2,3,1,1,1,3,2,3,3,1,3,1,1,3,1,1,1,1,3,2,1,2,3,2,7,3,2,1,3,2,2,6,2,3,1,1,3,1,2,2,3,3,3,1,2,3,1,2,3,1,2,2,3,3,2,3,2,1,3,3,1,3,2,3,
2,2,1,2,2,1,2,2,3,1,3,2,1,6,1,2,2,1,1,3,3,2,3,1,1,2,1,3,1,3,1,2,2,2,3,1,3,3,1,2,1,2,2,3,2,1,1,3,2,2,7,7,2,3,3,1,3,3,3,3,3,3,1,2,2,1,1,1,1,3,1,1,2,1,1,1,3,1,1,2,2,3,2,3,2,1,3,1,3,2,3,2,2,3,3,2,2,2,2,2,6,3,3,3,1,3,1,9,1,1,3,9,1,1,1,3,1,1,3,1,3,3,1,1,3,3,1,3,2,2,7,1,2,3,1,2,3,3,1,1,1,2,1,2,2,3,1,2,9,3,1,2,3,2,2,2,2,2,1,2,2,3,1,1,1,3,2,2,2,2,2,1,3,2,3,1,2,2,3,2,9,2,2,3,3,3,2,1,1,2,3,2,2,1,3,2,2,2,9,3,2,1,1,3,3,1,3,1,9,2,2,1,1,1,1,2,1,1,2,1,1,2,1,2,3,1,1,3,3,1,2,3,2,2,2,6,3,2,2,3,1,2,1,2,3,3,3,2,3,2,3,1,2,1,3,2,3,1,3,2,2,1,3,2,2,1,3,2,1,2,3,3,2,2,2,2,2,2,2,3,1,1,3,2,2,1,3,2,2,2,1,1,1,1,3,2,2,2,3,3,1,2,2,1,1,9,1,1,2,3,3,1,3,1,1,3,3,1,2,3,2,2,2,2,1,2,1,1,2,2,3,3,1,2,1,3,1,3,2,1,2,1,3,1,2,2,1,3,3,2,1,2,1,2,3,2,5,2,3,3,1,2,3,3,3,2,3,1,5,1,1,1,3,1,2,2,1,2,2,3,1,1,3,2,3,1,1,1,
2,3,2,2,2,3,3,1,1,1,2,1,2,3,3,3,2,1,3,2,3,3,2,1,3,3,2,3,2,3,1,2,1,1,2,3,1,2,1,2,1,3,3,1,3,2,2,3,3,3,1,2,1,1,2,3,3,3,2,3,3,1,2,1,1,2,1,3,3,3,2,2,2,3,1,3,2,2,1,2,3,1,1,1,1,1,1,9,9,3,3,1,3,1,2,1,1,2,2,3,3,1,1,3,3,3,2,2,3,3,3,9,1,3,1,2,1,1,3,1,3,2,1,3,3,3,3,1,2,1,1,3,2,2,3,1,1,1,3,3,2,1,1,3,2,2,3,1,3,2,2,3,3,3,1,2,1,9,1,2,2,1,1,3,8,1,3,1,3,2,2,2,1,3,2,2,3,2,2,1,2,3,2,3,3,1,3,1,1,1,2,2,1,1,2,3,2,1,1,2,2,8,2,9,1,1,3,2,3,2,1,2,3,2,2,1,3,1,2,1,1,3,3,2,2,1,1,9,3,2,2,3,2,1,3,1,2,1,1,2,2,3,2,2,3,3,1,3,1,1,2,8,3,2,1,7,3,2,2,2,2,3,3,1,1,1,1,2,2,2,1,1,2,8,3,3,2,1,1,2,3,3,2,2,2,1,2,2,3,2,7,2,2,2,6,1,2,3,3,3,2,2,2,3,3,1,2,3,1,3,2,1,2,2,3,3,1,1,3,3,2,1,3,1,1,2,3,1,2,2,3,1,3,3,1,2,1,3,4,1,2,3,3,1,2,1,4,5,2,2,3,3,3,2,2,2,3,1,2,1,1,3,2,1,1,1,1,2,2,3,7,2,2,2,3,1,2,3,1,2,5,2,3,3,1,3,1,3,
1,2,1,2,1,1,3,2,6,3,1,1,1,2,2,1,1,1,3,1,2,3,2,3,2,2,3,1,1,1,2,3,1,3,3,1,3,1,2,2,3,3,1,2,3,1,3,3,9,3,2,2,3,1,2,2,2,3,1,2,1,2,3,1,2,1,2,3,1,3,2,2,1,3,3,3,1,2,3,3,3,3,3,1,1,3,3,2,1,1,3,3,1,2,3,1,1,3,3,3,1,3,3,1,2,8,3,1,3,1,1,2,2,1,2,3,2,1,1,2,3,2,2,9,8,2,1,2,3,2,3,1,1,3,3,1,3,2,2,3,3,3,2,3,2,3,2,1,2,2,2,1,3,2,1,1,3,1,2,1,1,1,2,2,1,3,3,2,7,3,3,3,3,3,3,2,3,1,2,1,3,1,3,3,1,1,8,2,1,1,1,2,2,3,1,2,1,1,2,1,3,1,2,7,2,2,3,2,1,3,1,3,1,3,2,2,3,1,1,3,2,2,3,1,1,3,1,3,2,3,3,3,1,1,2,3,3,3,3,3,2,1,1,2,1,1,1,1,2,1,3,1,3,3,2,3,1,3,1,3,1,1,2,1,3,3,3,1,3,1,3,1,1,2,2,1,3,3,1,3,1,3,1,2,3,3,1,1,9,3,1,3,1,3,1,1,1,2,1,2,2,2,3,1,3,2,1,1,3,3,3,3,2,1,1,1,2,1,1,2,3,1,1,3,1,1,2,1,1,1,2,2,3,1,3,3,3,2,2,3,2,2,6,1,3,3,3,3,1,1,2,3,1,2,1,1,2,1,3,3,1,1,3,1,2,3,2,1,2,2,3,1,1,2,3,1,2,3,2,2,1,6,1,1,2,3,1,3,
2,2,9,1,2,3,3,1,1,2,1,2,2,3,1,3,2,3,1,2,2,1,1,3,1,2,2,2,1,2,3,3,3,1,1,2,1,3,2,3,9,3,2,3,1,2,1,3,2,3,1,1,3,2,2,3,1,1,3,3,1,1,2,2,3,2,2,1,1,1,2,3,2,3,1,1,3,2,1,2,3,1,1,1,2,1,2,2,3,2,3,3,3,2,1,1,3,3,3,2,2,2,3,1,3,1,3,2,2,2,3,3,3,2,1,1,2,3,2,2,1,2,2,2,2,2,3,3,3,2,1,1,2,3,3,3,1,2,1,1,2,1,1,3,3,1,3,3,3,1,1,1,1,1,3,1,1,2,2,1,3,2,3,1,2,2,1,3,2,1,3,3,2,2,3,3,1,2,1,3,3,1,3,2,9,3,3,2,1,2,3,3,3,1,1,2,3,2,3,1,1,1,3,2,2,8,1,1,3,3,1,3,3,3,8,2,2,6,1,2,3,1,1,3,2,2,3,2,2,3,1,1,2,1,3,1,1,3,1,2,2,1,1,3,2,1,1,3,1,1,3,3,2,1,2,2,3,1,1,6,1,1,3,3,1,2,3,3,2,3,2,2,3,3,1,1,2,2,2,3,1,1,3,2,1,1,2,1,1,1,3,1,2,2,3,2,2,3,3,2,1,2,2,1,2,3,3,2,2,1,1,3,6,9,1,1,1,3,1,2,2,3,1,2,3,9,3,2,3,3,3,1,1,3,1,1,3,1,3,1,3,2,3,2,5,2,2,1,2,3,3,3,7,1,1,1,1,3,2,1,3,1,2,2,1,3,1,1,3,2,3,3,1,3,3,1,3,3,1,2,1,2,2,1,2,3,3,2,
3,2,2,1,3,3,3,2,1,2,1,1,3,2,2,2,1,2,3,1,1,1,2,3,1,1,1,3,3,3,1,2,1,3,3,3,1,2,1,2,3,1,1,2,2,2,2,1,3,8,8,7,2,1,2,2,3,1,1,2,1,1,1,9,3,3,1,2,1,2,3,3,3,3,2,2,1,1,3,2,3,1,1,2,3,3,1,1,8,2,3,3,1,3,2,2,3,2,1,1,1,1,3,2,1,1,3,9,3,2,9,3,2,3,2,3,3,1,1,3,3,1,2,3,3,2,1,2,2,2,3,2,3,2,3,2,2,3,3,1,3,1,2,1,2,3,2,3,3,2,3,2,1,2,3,2,3,3,1,1,2,2,3,3,3,2,3,1,3,3,1,2,1,1,3,8,2,1,3,3,2,3,2,2,1,3,2,2,1,1,2,2,3,2,1,2,1,3,3,2,1,1,3,3,2,3,3,2,1,3,2,3,2,3,3,1,1,2,3,1,3,1,3,3,3,2,3,1,2,8,3,3,1,2,1,3,3,1,1,1,2,2,1,3,3,3,1,2,2,3,9,2,2,3,2,1,2,2,2,3,2,2,1,1,3,2,2,3,1,2,2,2,3,1,1,9,1,2,3,1,3,3,2,6,2,3,2,3,1,1,2,1,1,1,1,3,1,2,2,1,1,1,2,2,3,2,3,5,3,3,1,2,2,3,2,2,1,2,1,3,1,3,1,1,3,1,3,2,2,1,2,6,3,3,1,1,1,2,1,1,2,2,2,1,2,1,3,1,1,3,3,1,3,3,2,2,2,3,3,3,2,2,1,1,3,2,3,1,2,1,1,3,2,3,1,3,2,1,2,3,2,1,2,1,2,2,1,1,
1,1,3,3,3,2,3,1,2,2,1,1,2,3,2,2,2,3,1,1,2,1,7,2,3,1,2,1,2,2,2,1,3,1,2,2,3,1,1,2,8,3,3,1,2,2,2,8,3,1,3,2,1,2,2,2,1,2,2,2,2,2,2,2,3,3,2,1,3,1,3,3,3,3,3,3,2,1,2,2,2,1,1,2,1,2,3,3,3,1,3,3,2,1,3,2,3,1,2,2,2,8,2,2,3,3,3,1,1,3,3,3,2,3,1,1,3,2,3,3,2,1,2,3,3,1,2,1,3,3,1,1,1,1,3,2,1,2,1,2,2,1,3,2,3,1,2,2,3,1,2,2,1,3,8,1,1,3,1,2,3,2,2,2,1,3,1,2,2,3,3,2,3,1,2,2,7,1,1,3,2,1,1,1,7,2,1,2,2,2,1,1,3,2,1,2,3,3,1,2,1,1,7,3,1,1,3,1,1,2,1,1,3,3,3,1,1,2,1,2,1,2,1,1,2,1,2,1,3,3,1,1,1,1,3,1,3,2,2,1,2,2,1,8,2,3,1,1,3,3,2,7,1,1,2,2,2,3,3,1,1,3,2,2,3,2,2,6,1,1,1,2,2,1,2,2,1,1,3,1,2,2,2,3,3,1,1,2,2,1,2,2,2,3,1,3,1,1,2,1,1,1,3,3,3,1,2,3,1,3,3,3,2,2,2,1,3,1,2,3,1,2,1,7,2,2,1,1,2,3,1,3,2,3,3,3,2,1,2,3,3,2,2,2,3,3,1,2,3,2,2,2,2,1,2,3,1,3,6,5,2,2,2,3,3,3,3,7,2,1,1,2,3,2,3,1,4,2,1,1,1,1,1,3,2,1,3,2,
3,1,2,1,2,3,2,2,2,3,2,3,2,2,3,1,3,1,3,1,8,2,2,2,2,3,3,3,3,1,2,3,1,3,2,2,3,2,3,2,3,2,2,3,3,3,1,2,1,3,2,3,3,2,3,3,2,2,8,3,2,3,3,2,3,1,1,1,1,3,2,3,3,2,3,1,2,2,1,3,3,7,3,3,3,2,2,2,2,2,1,1,2,1,1,2,1,1,3,1,3,2,1,1,1,3,3,1,3,2,3,1,2,2,2,2,2,2,3,3,2,1,2,3,3,1,2,2,3,1,3,2,3,1,1,3,1,3,1,3,2,1,2,1,1,3,1,3,2,3,2,3,3,1,1,3,1,1,1,3,1,2,3,2,3,2,1,3,3,3,3,2,1,3,1,2,3,2,3,2,2,1,2,1,3,2,2,2,1,1,1,2,3,3,3,3,3,2,3,2,1,2,1,1,2,2,3,3,1,1,3,2,2,1,3,2,3,2,3,2,3,1,1,2,1,1,2,1,1,3,1,2,1,3,6,3,3,2,2,3,1,1,3,2,3,3,1,3,1,3,3,3,1,8,1,1,3,1,1,2,3,3,3,2,3,3,2,2,2,3,1,3,2,2,1,3,3,3,1,2,2,2,1,1,3,2,2,2,3,2,2,2,1,1,3,3,2,3,6,3,2,3,1,2,1,1,2,2,3,1,3,1,1,2,3,2,1,1,3,1,2,1,3,2,1,2,3,1,2,2,1,3,1,2,1,2,1,1,1,1,2,3,2,1,1,1,3,2,3,5,3,1,1,2,3,2,3,2,3,3,2,1,2,3,3,3,3,4,1,3,2,2,2,2,2,2,2,1,7,3,1,3,6,1,1,2,1,1,
7,2,2,3,1,1,2,1,3,2,3,6,3,3,3,2,1,2,2,3,2,2,1,3,2,3,3,1,1,1,2,3,2,2,2,3,1,2,1,2,3,3,2,1,3,3,1,2,1,2,1,1,3,3,3,2,3,1,2,3,1,3,3,1,1,1,3,2,2,3,3,1,1,2,3,2,1,2,1,2,1,2,1,3,2,1,2,3,2,3,3,2,2,2,2,3,3,2,2,3,1,3,2,2,7,1,2,1,3,2,3,3,3,2,1,2,3,2,2,9,1,3,1,3,1,1,2,1,3,1,3,1,2,1,3,1,3,3,3,1,2,1,1,2,3,3,1,1,6,3,3,1,2,2,1,9,2,7,3,3,2,3,1,1,2,1,2,1,3,2,2,3,3,3,2,1,2,1,2,2,2,3,3,8,1,1,2,3,3,1,3,1,1,1,1,1,1,3,3,2,1,2,3,3,2,3,2,1,3,3,3,2,2,1,2,1,1,1,2,2,3,3,2,3,3,3,2,2,2,3,2,3,3,1,3,1,2,3,3,1,2,2,2,7,2,3,1,3,3,3,3,1,2,2,2,1,1,3,1,3,2,3,2,1,1,3,2,2,2,1,3,3,1,2,2,3,3,3,1,1,3,3,2,2,2,2,1,2,1,1,3,1,2,1,1,3,2,2,1,2,1,2,2,3,7,1,3,1,1,1,2,2,3,2,1,1,1,1,2,2,3,1,3,1,3,7,3,3,1,3,2,2,3,2,3,4,1,2,3,1,3,2,2,3,3,2,1,6,1,1,1,2,2,2,1,7,8,2,3,3,2,3,1,2,2,4,1,2,1,2,3,1,2,3,1,3,1,2,2,2,3,2,3,1,1,1,1,3,
3,1,3,2,3,2,2,9,1,2,3,1,1,3,2,1,1,8,7,3,2,2,1,2,2,2,1,3,1,3,2,3,2,3,3,2,2,2,1,1,2,2,1,3,2,2,3,3,1,2,1,1,2,2,3,3,1,3,3,3,1,3,2,3,1,2,1,3,1,2,2,1,3,3,2,1,2,2,1,1,3,2,2,2,1,9,2,2,3,1,2,1,3,2,1,2,3,3,3,2,1,3,2,3,1,1,2,2,2,1,1,2,2,3,2,1,3,2,1,2,3,2,1,1,3,2,1,1,1,1,2,1,1,3,3,1,3,1,2,1,3,3,1,2,1,2,2,1,3,2,3,1,1,1,7,3,3,1,3,3,3,3,3,1,1,3,3,1,1,3,1,3,3,1,2,3,3,7,3,3,2,3,1,3,1,3,2,6,2,2,1,1,3,3,1,2,3,2,2,3,1,3,1,2,2,2,3,1,3,3,3,3,1,2,2,1,1,1,3,3,2,3,8,2,1,2,1,1,2,3,2,1,3,1,1,3,3,2,2,3,2,2,2,2,1,3,2,3,2,2,3,2,3,2,1,1,3,1,2,1,2,1,1,2,1,1,1,1,1,1,2,3,1,2,1,2,3,2,1,1,1,1,2,3,2,3,2,2,3,2,1,1,1,3,1,1,1,2,3,1,1,2,3,7,3,1,1,2,2,2,1,3,2,2,3,3,2,2,1,2,1,1,2,2,2,2,3,2,1,1,2,1,1,3,2,1,2,3,3,3,3,3,3,3,1,1,2,1,1,3,3,1,3,3,3,3,2,1,2,3,3,2,3,2,2,1,2,3,2,3,3,3,3,2,2,1,1,2,3,3,2,3,1,1,1,1,1,3,
1,3,6,1,2,2,1,3,1,1,2,2,3,2,2,3,3,3,1,3,2,1,2,3,2,2,2,3,3,2,1,2,2,1,2,1,1,1,1,1,1,1,2,1,3,3,1,2,2,3,3,3,2,2,3,2,1,1,1,2,2,1,1,1,3,3,1,2,1,3,1,2,3,1,3,3,2,3,2,2,1,2,3,1,1,1,3,2,2,1,1,1,1,2,3,3,1,2,2,3,1,2,2,3,3,1,3,3,3,3,1,1,3,1,1,2,3,1,2,3,1,1,1,2,3,6,3,3,2,2,3,3,1,2,3,1,1,1,3,2,2,2,3,2,1,3,3,8,3,1,3,3,1,1,2,1,1,1,2,3,1,2,3,1,3,2,1,1,3,3,1,1,2,2,3,3,1,3,2,3,2,1,1,2,1,1,3,1,1,1,1,2,2,3,1,2,2,3,3,3,3,7,2,3,1,1,3,3,3,1,7,3,2,3,2,2,1,2,1,1,3,3,2,3,2,3,3,1,2,7,2,2,3,3,1,1,3,1,2,3,3,2,3,3,2,3,1,2,2,2,2,2,1,1,2,1,3,2,1,3,1,2,3,1,1,2,3,3,3,3,1,1,3,1,1,1,1,2,1,3,6,3,1,1,2,3,3,1,1,2,3,2,6,3,3,1,2,3,2,2,1,1,1,1,1,2,2,8,3,2,1,1,3,1,3,2,3,3,8,1,1,2,3,1,3,2,2,2,2,2,3,2,1,2,2,1,1,2,3,3,3,2,1,1,1,3,3,3,6,3,2,2,2,3,5,1,1,2,2,3,1,1,3,1,3,2,2,1,2,1,2,3,2,2,3,2,3,6,3,3,2,3,6,2,1,3,3,2,
2,1,3,1,1,2,2,2,2,1,3,2,3,2,2,2,2,3,3,3,2,2,3,1,2,3,1,2,2,1,2,3,3,2,1,3,1,2,1,3,3,1,6,2,1,3,3,3,2,3,2,1,3,3,3,1,3,2,3,1,1,1,1,1,8,2,1,3,1,2,1,1,1,1,1,2,1,1,2,3,3,1,1,1,1,2,2,1,3,2,8,1,2,1,3,3,2,1,1,1,3,1,2,1,8,3,3,3,2,3,3,1,1,1,2,1,2,2,2,1,1,1,1,3,1,3,2,3,7,3,3,2,2,2,1,3,8,2,2,2,1,3,2,1,2,8,2,1,2,1,8,1,2,3,2,2,3,3,2,1,1,3,2,1,2,2,3,2,2,1,2,1,1,3,3,2,2,3,2,1,3,2,1,2,3,1,1,1,3,3,1,2,2,1,2,2,2,3,3,1,1,2,1,3,1,3,3,2,3,2,3,3,1,9,1,2,2,1,2,2,2,2,1,2,2,2,1,3,3,3,3,1,1,2,2,1,3,3,3,2,1,3,2,3,3,2,2,3,2,2,3,1,2,1,2,1,9,1,3,3,3,3,1,2,1,1,3,3,2,3,2,3,1,2,3,2,7,1,1,2,1,1,1,1,3,2,2,2,3,2,1,3,6,3,2,3,1,2,2,1,3,1,3,1,1,2,3,1,1,2,9,3,3,2,2,2,8,1,1,2,3,1,3,2,3,3,7,3,1,1,2,2,2,3,1,1,3,3,2,3,3,3,1,3,5,1,3,3,3,4,1,3,2,2,2,3,3,3,2,2,2,3,1,1,2,5,2,1,2,2,3,1,2,2,3,5,2,2,3,2,3,2,3,7,3,3,1,2,
3,1,3,2,2,3,1,1,1,1,3,1,6,9,2,1,3,3,3,2,3,2,3,1,3,2,2,2,2,2,1,1,3,1,3,1,1,3,1,3,1,1,3,3,2,6,1,7,1,1,3,1,1,2,2,2,1,1,3,3,2,3,3,3,2,3,2,1,6,1,2,1,3,3,3,3,3,1,1,2,1,2,9,3,6,2,3,2,3,3,3,1,1,2,2,2,3,3,1,2,2,3,3,1,1,2,1,2,2,2,1,1,1,2,3,2,3,1,3,1,2,3,2,2,3,2,1,2,2,3,1,1,2,3,3,1,1,2,1,3,1,3,1,3,2,1,1,2,1,2,2,3,3,8,2,2,2,3,3,3,1,2,1,1,1,3,1,8,3,3,1,2,1,2,3,1,2,1,3,1,2,2,3,1,2,1,2,3,2,3,3,1,1,2,1,1,1,2,3,1,1,3,2,3,3,2,1,3,1,1,3,1,1,2,2,1,1,3,2,2,1,2,1,2,3,2,2,2,3,1,2,1,2,2,3,3,3,2,1,2,3,1,1,2,3,1,7,3,1,3,2,3,1,1,2,2,2,2,3,2,2,1,6,1,2,2,1,2,1,1,2,1,1,9,1,2,1,6,3,1,1,2,1,3,1,9,1,3,2,2,2,2,1,3,2,2,1,2,2,2,2,2,6,1,3,2,1,1,2,1,9,2,1,2,1,3,3,2,2,1,2,2,3,1,2,1,1,3,3,1,1,1,3,2,2,1,3,3,3,5,3,1,3,3,3,2,1,3,2,2,3,1,3,3,2,2,1,1,3,1,2,3,3,1,3,1,3,3,3,2,2,1,1,1,1,3,2,2,3,2,1,1,1,5,3,1,1,3,
1,3,2,1,1,3,2,1,2,2,1,3,3,1,3,1,3,1,2,1,2,1,1,3,2,1,1,2,6,2,1,3,2,1,2,2,1,3,2,3,1,1,1,1,1,3,3,1,1,2,2,1,3,2,2,3,3,3,3,2,1,3,1,3,3,1,2,3,2,2,2,3,1,2,2,3,3,3,3,3,3,3,1,2,1,2,2,8,1,3,2,3,2,2,2,1,2,1,1,3,1,1,1,1,3,6,3,1,1,1,3,1,1,3,2,1,2,2,2,1,1,1,2,3,2,1,2,3,2,2,2,3,9,3,1,3,1,1,3,2,1,3,3,2,2,3,3,3,2,2,2,3,2,2,3,2,3,2,2,2,3,3,3,2,2,1,3,3,1,1,3,1,2,1,3,2,3,1,9,1,1,1,1,1,2,2,3,1,1,2,2,7,2,1,1,2,1,1,3,2,9,2,1,1,2,3,1,2,2,3,3,2,2,2,2,3,3,3,2,1,3,3,3,3,3,3,3,2,9,1,2,2,1,1,3,3,3,1,1,3,7,2,2,1,2,1,2,3,2,1,3,2,3,1,2,2,2,3,3,1,1,2,2,3,3,2,3,1,1,2,1,1,3,5,1,1,3,3,2,3,2,2,3,1,1,1,2,2,2,3,3,2,1,2,1,2,3,2,3,3,2,3,2,3,2,3,1,1,1,2,2,3,1,3,1,7,3,1,2,3,8,3,3,1,3,2,1,1,2,1,2,1,1,2,3,3,3,1,1,3,6,1,2,3,2,2,2,2,2,2,1,2,3,2,3,1,2,3,4,2,1,1,2,1,3,3,3,3,2,2,1,2,2,1,3,2,1,3,3,1,2,2,1,2,3,3,3,1,
2,1,2,2,3,1,3,3,3,3,1,3,8,1,2,2,3,3,2,1,3,2,2,2,2,2,3,3,1,3,2,3,2,2,2,3,2,3,1,1,2,2,1,3,1,3,1,3,3,3,1,1,2,2,1,3,2,3,3,3,2,1,3,1,1,3,2,3,2,3,1,1,2,2,2,2,2,3,3,2,3,3,3,3,2,2,2,3,1,1,3,3,2,2,1,2,1,1,1,3,1,3,2,2,3,2,3,1,1,1,1,3,2,1,2,3,3,2,3,2,1,3,1,3,2,3,2,2,3,3,1,2,2,3,2,3,1,1,1,3,2,2,1,3,2,3,3,3,1,3,2,2,1,2,3,2,9,1,1,1,1,1,1,3,1,3,1,2,3,2,1,1,3,1,7,3,2,3,3,3,2,3,1,1,2,3,3,1,3,3,1,1,3,2,1,2,1,2,1,2,2,3,3,2,3,3,2,3,2,3,3,1,2,2,1,1,3,2,2,2,3,3,1,3,2,1,3,2,1,1,2,1,3,3,2,1,1,1,2,2,3,3,2,3,2,3,2,2,2,2,3,1,3,1,3,3,2,3,2,1,1,1,3,1,1,1,8,3,1,1,3,3,3,2,2,3,2,2,3,2,3,3,2,2,1,3,2,1,3,3,2,2,1,3,2,1,3,1,2,1,1,1,2,3,3,1,1,1,3,2,1,3,2,1,2,1,2,1,2,2,3,3,1,3,1,3,2,3,1,1,1,1,3,6,1,2,1,1,3,2,2,3,3,2,3,6,3,1,2,2,8,2,1,2,1,3,2,1,3,3,2,2,2,3,1,3,1,3,1,2,4,2,1,1,1,1,2,2,2,2,1,2,3,7,3,2,3,1,
1,1,2,3,1,2,3,3,1,2,1,3,3,2,2,3,6,1,1,1,3,1,2,2,1,3,2,1,1,1,7,1,2,3,3,2,2,3,1,3,2,3,1,9,2,3,9,3,2,2,1,3,3,2,2,2,1,2,2,3,1,2,2,2,2,1,2,1,3,1,1,3,3,3,2,2,1,1,1,3,3,2,3,2,1,3,1,2,2,1,3,2,2,3,3,2,3,3,1,1,1,1,3,9,3,1,1,1,1,1,2,3,2,1,1,1,1,3,2,2,1,3,3,2,1,8,2,2,2,3,3,1,1,3,3,2,1,3,2,3,1,3,1,3,1,2,1,2,1,2,1,1,3,1,7,3,3,3,1,2,2,1,1,1,1,2,1,1,2,2,1,1,1,2,1,2,1,1,1,3,3,1,9,2,3,1,3,3,1,3,2,2,3,3,2,1,1,2,1,2,2,1,2,2,1,2,2,2,2,1,2,2,3,7,3,2,2,7,2,3,3,2,2,1,2,1,2,2,1,3,2,1,1,3,1,1,7,1,3,1,1,3,2,1,1,2,1,2,7,1,2,3,3,2,2,2,3,1,2,2,2,1,2,2,3,1,1,3,2,3,1,3,1,3,3,1,3,1,1,2,3,3,9,3,2,2,2,1,1,1,1,3,7,3,3,3,1,3,7,3,1,3,2,2,2,1,1,2,1,3,1,3,3,1,2,1,1,1,2,2,1,1,3,2,2,1,3,3,3,1,7,3,3,2,1,2,3,1,2,2,3,2,2,2,2,1,3,1,4,2,2,3,3,6,2,3,2,2,2,1,3,1,2,2,2,3,3,2,3,2,2,2,3,1,1,2,3,2,2,2,3,2,2,3,1,2,1,2